......%%..........%%......
......%%..........%%......
...~~................~~...
######%....####....%######
..........................
........%%%%%%%%%.........
........~~%%%%%~~.........
........%%%###%%%.........
@@@@@.......#........@@@@@
...........###............
..........#####...........
~~...~...#######...~....~~
~~...~..###@@@###..~....~~
...........@@@............
###........@@@.........###
####@##............##@####
#%##@##............##@##%#
..........................
.......####~~~#####.......
#####%%#%%......%%#%%#####
#####..#%%......%%#..#####
####...#####@@#####...####
###....#..........#....###
##.....#...####...#.....##
#......#...#..#...#......#
.......#...#..#...#.......