...~~~~~~........~~~~~~...
.....####........####.....
...#.....#......#....##...
...#@@@...#....#...@@@#...
...#%%%#...#..#...#%%%#...
##.#%%%#...####...#%%%#.##
##.#%%%#..#~%%~#..#%%%#.##
##.#%%%#.#~~%%~~#.#%%%#.##
##.#%%%##~~~%%~~~##%%%#.##
...#%%%#.#~~%%~~#.#%%%#...
###@@@@####~%%~####@@@@###
.....#.....####.....#.....
#....#....#%%%%#....#....#
.#...#...#%%%%%%#...#...#.
..#..#..#~~~~~~~~#..#..#..
...#.#.#%#......#%#.#.#...
....###%%%#....#%%%###....
....%#%%%%%#..#%%%%%#%....
....%.#%%%%%##%%%%%#.%....
....%.##%%%%##%%%%##.%....
....%.###@@@%%@@@###.%....
.###%###.#%%%%%%#.###%###.
.#..%@##..#%%%%#.-##@%..#.
.#..%@##-..#@@#..-##@%..#.
.#..%@##-..#..#..-##@%..#.
.#..%@##-..#..#..-##@%..#.