..........................
..........................
........##..##............
........##..##............
%%....%%##%%##%%....%%....
%%....%%##%%##%%....%%....
##%%%%##########%%%%##%%..
##%%%%##########%%%%##%%..
########@@##@@########%%..
########@@##@@########%%..
~~~~~~##########~~~~~~%%..
~~~~~~##########~~~~~~%%..
~~##################~~~~%%
~~##################~~~~%%
######~~######~~######%%%%
######~~######~~######%%%%
####~~~~~~##~~~~~~####~~~~
####~~~~~~##~~~~~~####~~~~
%%~~~~%%%%%%%%%%~~~~%%~~%%
%%~~~~%%%%%%%%%%~~~~%%~~%%
..%%%%..........%%%%..%%..
..%%%%..........%%%%..%%..
....%@##..................
....%@##~..#@@#...........
....%@##~..#..#...........
.#..%@##~..#..#...........